[
    [
        ["0", "0", "w", "0"],
        ["p", "b", "w", "0"],
        ["0", "0", "0", "0"],
        ["0", "e", "0", "0"]
    ],
    [
        ["w", "0", "0", "p"],
        ["w", "b", "w", "w"],
        ["0", "0", "w", "w"],
        ["0", "0", "0", "e"]
    ]
]